The Great Beacon Hill Egg Hunt
An Egg-stravagant Fiction by E. Bunny
Release 1 / Serial number 230412 / Inform 7 v10.1.2 / D

Bedroom
The master bedroom is tastefully furnished and has a vaulted ceiling. You can exit by going down, west, or east.

You can see a bed (on which is a pillow) and a blue backpack (closed) here.

>actions
Actions listing on.

>rules
Rules tracing now switched on. Type "rules off" to switch it off again, or "rules all" to include even rules which do not apply.

[Rule "parse command rule" applies.]

* * *

>open door
You can't see any such thing.

* * *

>open door
[Rule "declare everything initially unmentioned rule" applies.]
[Rule "generate action rule" applies.]
[opening the front door]
[Rule "announce items from multiple object lists rule" applies.]
[Rule "set pronouns from items from multiple object lists rule" applies.]
[Rule "before stage rule" applies.]
[Rule "basic visibility rule" applies.]
[Rule "basic accessibility rule" applies.]
[Rule "access through barriers rule" applies.]
[Rule "carrying requirements rule" applies.]
[Rule "instead stage rule" applies.]
[Rule "requested actions require persuasion rule" applies.]
[Rule "carry out requested actions rule" applies.]
[Rule "descend to specific action-processing rule" applies.]
[Rule "work out details of specific action rule" applies.]
[Rule "investigate player's awareness before action rule" applies.]
[Rule "player aware of his own actions rule" applies.]
[Rule "check stage rule" applies.]
[Rule "can't open unless openable rule" applies.]
[Rule "can't open what's locked rule" applies.]
[Rule "can't open what's already open rule" applies.]
[Rule "carry out stage rule" applies.]
[Rule "standard opening rule" applies.]
[Rule "after stage rule" applies.]
[Rule "investigate player's awareness after action rule" applies.]
[Rule "report stage rule" applies.]
[Rule "reveal any newly visible interior rule" applies.]
[Rule "standard report opening rule" applies.]
You open the front door.
[Rule "last specific action-processing rule" applies.]
[opening the front door - succeeded]

[Rule "A first turn sequence rule" applies.]
[Rule "scene change machinery rule" applies.]
[Rule "every turn stage rule" applies.]
[Rule "timed events rule" applies.]
[Rule "advance time rule" applies.]
[Rule "update chronological records rule" applies.]
[Rule "A last turn sequence rule" applies.]
[Rule "scene change machinery rule" applies.]
[Rule "adjust light rule" applies.]
[Rule "note object acquisitions rule" applies.]
[Rule "notify score changes rule" applies.]
[Rule "parse command rule" applies.]

* * *

>x bed
[Rule "declare everything initially unmentioned rule" applies.]
[Rule "generate action rule" applies.]
[examining the flower bed]
[Rule "announce items from multiple object lists rule" applies.]
[Rule "set pronouns from items from multiple object lists rule" applies.]
[Rule "before stage rule" applies.]
[Rule "basic visibility rule" applies.]
[Rule "can't act in the dark rule" applies.]
[Rule "basic accessibility rule" applies.]
[Rule "carrying requirements rule" applies.]
[Rule "instead stage rule" applies.]
[Rule "Instead of examining the flower bed" applies.]
You notice a pink egg between the plants!
[examining the flower bed - failed]

[Rule "A first turn sequence rule" applies.]
[Rule "scene change machinery rule" applies.]
[Rule "every turn stage rule" applies.]
[Rule "timed events rule" applies.]
[Rule "advance time rule" applies.]
[Rule "update chronological records rule" applies.]
[Rule "A last turn sequence rule" applies.]
[Rule "scene change machinery rule" applies.]
[Rule "adjust light rule" applies.]
[Rule "note object acquisitions rule" applies.]
[Rule "notify score changes rule" applies.]
[Rule "parse command rule" applies.]

>get egg
[Rule "declare everything initially unmentioned rule" applies.]
[Rule "generate action rule" applies.]
[taking the pink egg]
[Rule "announce items from multiple object lists rule" applies.]
[Rule "set pronouns from items from multiple object lists rule" applies.]
[Rule "before stage rule" applies.]
[Rule "basic visibility rule" applies.]
[Rule "basic accessibility rule" applies.]
[Rule "access through barriers rule" applies.]
[Rule "can't reach inside rooms rule" applies.]
[Rule "can't reach inside closed containers rule" applies.]
[Rule "carrying requirements rule" applies.]
[Rule "instead stage rule" applies.]
[Rule "requested actions require persuasion rule" applies.]
[Rule "carry out requested actions rule" applies.]
[Rule "descend to specific action-processing rule" applies.]
[Rule "work out details of specific action rule" applies.]
[Rule "investigate player's awareness before action rule" applies.]
[Rule "player aware of his own actions rule" applies.]
[Rule "check stage rule" applies.]
[Rule "can't take yourself rule" applies.]
[Rule "can't take other people rule" applies.]
[Rule "can't take component parts rule" applies.]
[Rule "can't take people's possessions rule" applies.]
[Rule "can't take items out of play rule" applies.]
[Rule "can't take what you're inside rule" applies.]
[Rule "can't take what's already taken rule" applies.]
[Rule "can't take scenery rule" applies.]
[Rule "can only take things rule" applies.]
[Rule "can't take what's fixed in place rule" applies.]
[Rule "use player's holdall to avoid exceeding carrying capacity rule" applies.]
[Rule "can't exceed carrying capacity rule" applies.]
[Rule "carry out stage rule" applies.]
[Rule "standard taking rule" applies.]
[Rule "after stage rule" applies.]
[Rule "investigate player's awareness after action rule" applies.]
[Rule "report stage rule" applies.]
[Rule "standard report taking rule" applies.]
Taken.
[Rule "last specific action-processing rule" applies.]
[taking the pink egg - succeeded]

[Rule "A first turn sequence rule" applies.]
[Rule "scene change machinery rule" applies.]
[Rule "every turn stage rule" applies.]
[Rule "timed events rule" applies.]
[Rule "advance time rule" applies.]
[Rule "update chronological records rule" applies.]
[Rule "A last turn sequence rule" applies.]
[Rule "scene change machinery rule" applies.]
[Rule "adjust light rule" applies.]
[Rule "note object acquisitions rule" applies.]
[Rule "notify score changes rule" applies.]
[Rule "parse command rule" applies.]

>open egg
[Rule "declare everything initially unmentioned rule" applies.]
[Rule "generate action rule" applies.]
[opening the pink egg]
[Rule "announce items from multiple object lists rule" applies.]
[Rule "set pronouns from items from multiple object lists rule" applies.]
[Rule "before stage rule" applies.]
[Rule "basic visibility rule" applies.]
[Rule "basic accessibility rule" applies.]
[Rule "access through barriers rule" applies.]
[Rule "carrying requirements rule" applies.]
[Rule "instead stage rule" applies.]
[Rule "requested actions require persuasion rule" applies.]
[Rule "carry out requested actions rule" applies.]
[Rule "descend to specific action-processing rule" applies.]
[Rule "work out details of specific action rule" applies.]
[Rule "investigate player's awareness before action rule" applies.]
[Rule "player aware of his own actions rule" applies.]
[Rule "check stage rule" applies.]
[Rule "can't open unless openable rule" applies.]
It isn't something you can open.
[opening the pink egg - failed the can't open unless openable rule]

[Rule "A first turn sequence rule" applies.]
[Rule "scene change machinery rule" applies.]
[Rule "every turn stage rule" applies.]
[Rule "timed events rule" applies.]
[Rule "advance time rule" applies.]
[Rule "update chronological records rule" applies.]
[Rule "A last turn sequence rule" applies.]
[Rule "scene change machinery rule" applies.]
[Rule "adjust light rule" applies.]
[Rule "note object acquisitions rule" applies.]
[Rule "notify score changes rule" applies.]
[Rule "parse command rule" applies.]

I beg your pardon?

>showme egg
(the pink egg)
[Rule "declare everything initially unmentioned rule" applies.]
[Rule "generate action rule" applies.]
pink egg - thing
location: carried by yourself in 21stBayview
unlit, inedible, portable, handled; singular-named, improper-named
description: none
initial appearance: none
printed name: "pink egg"
printed plural name: none
indefinite article: none
list grouping key: none

[Rule "parse command rule" applies.]

>showme red egg
[Rule "declare everything initially unmentioned rule" applies.]
[Rule "generate action rule" applies.]
red Easter egg - closed container
    message
location: in the nightstand in the Bedroom
unlit, inedible, portable; opaque, closed, openable, unlocked; singular-named, improper-named
description: none
initial appearance: none
carrying capacity: 100
printed name: "red Easter egg"
printed plural name: "containers"
indefinite article: none
list grouping key: none

[Rule "parse command rule" applies.]

* * *

The Great Beacon Hill Egg Hunt
An Egg-stravagant Fiction by E. Bunny
Release 1 / Serial number 230412 / Inform 7 v10.1.2 / D

Bedroom
The master bedroom is tastefully furnished and has a vaulted ceiling. You can exit by going down, west, or east.

You can see a bed (on which is a pillow) and a blue backpack (closed) here.

>d
Living Room
There are big windows here and a comfy looking recliner. You can go up, northwest, north, or west into the garage.

You can see a garage door, a couch and a footrest (closed) here.

>n
Kitchen
You can see a back door, a stove (on which is a pot) and a fridge (closed) here.

>e
Bonk! The back door is closed.

>open door
You open the back door.

>e
Back Yard
Nice trampoline here.

You can see a back door here.

>w
Kitchen
You can see a back door, a stove (on which is a pot) and a fridge (closed) here.

>w
Dining Room
You can see a table (on which is an utensil holder) and a cupboard (closed) here.

>w
Front Room
You can see a front door, a rack (on which is a coat) and a bin (closed) here.

>w
Bonk! The front door is closed.

>open door
You open the front door.

>w
Front Porch
You are on a wooden front porch next to a Smith Brothers milk bin.

You can see a front door and a mailbox (in which is an envelope (in which is a letter)) here.

>w
Front Yard
A nice front yard with a yellow fire hydrant.

>sw
21st & Bayview
You are at a nice traffic circle. An inviting sidewalk beckons to the south.

>ne
Front Yard
A nice front yard with a yellow fire hydrant.

>e
Front Porch
You are on a wooden front porch next to a Smith Brothers milk bin.

You can see a front door and a mailbox (in which is an envelope (in which is a letter)) here.

>e
Front Room
You can see a front door, a rack (on which is a coat) and a bin (closed) here.

>e
Dining Room
You can see a table (on which is an utensil holder) and a cupboard (closed) here.

>open cupboard
You open the cupboard, revealing an orange Easter egg.

>e
Kitchen
You can see a back door, a stove (on which is a pot) and a fridge (closed) here.

>open fridge
You open the fridge, revealing a blue Easter egg.

>w
Dining Room
You can see a table (on which is an utensil holder) and a cupboard (in which is an orange Easter egg) here.

>w
Front Room
You can see a front door, a rack (on which is a coat) and a bin (closed) here.

>w
Front Porch
You are on a wooden front porch next to a Smith Brothers milk bin.

You can see a front door and a mailbox (in which is an envelope (in which is a letter)) here.

* * *

>e
Bonk! The back door is closed.

>open it
You open the fridge, revealing a blue Easter egg.

>open door
You open the back door.

>e
Back Yard
You can see a back door here.

>w
Kitchen
You can see a back door, a stove (on which is a pot) and a fridge (in which is a blue Easter egg) here.

>w
Dining Room
You can see a table (on which is an utensil holder) and a cupboard (closed) here.

* * *

>open door
You open the front door.

>w
Front Porch
You can see a front door and a mailbox (in which is an envelope (in which is a letter)) here.

>w
Front Yard

>sw
21st & Bayview
You are at a nice traffic circle. An inviting sidewalk beckons to the south.

>s
21st & Stevens

* * *

>e
Bonk! The back door is closed.

>w
Kitchen
You can see a stove (on which is a pot) and a fridge (closed) here.

>w
Dining Room
You can see a table (on which is an utensil holder) and a cupboard (closed) here.

* * *

>w
Front Yard

>sw
21st & Bayview

>s
21st & Stevens

>n
21st & Bayview

>w
You can't go that way.

* * *

>n
Kitchen
You can see a back door, a stove (on which is a pot) and a fridge (closed) here.

>n
You can't go that way.

>w
Dining Room
You can see a table (on which is an utensil holder) and a cupboard (closed) here.

* * *

>w
Front Room
You can see a front door, a rack (on which is a coat) and a bin (closed) here.

>open door
You open the front door.

* * *

>sw
21st & Bayview
You are at a nice traffic circle. An inviting sidewalk beckons to the south.

>s
21st & Forest
You are at a traffic circle to the east of the library.

>se
22nd & Stevens
Great looking traffic circle on 22nd.

>s
The Bowl
A dip in the street from all directions, looks like an interesting place to ride a bike.

>w
Arrow Bench
An attractive spot with a beautiful wooden bench in the shape of an arrow.

>w
National Park
You look out toward the Cascades.  What a view!

>sw
Firehouse
A lovely old firehouse from 1930 with a story illustrated on rocks out front.

>n
Library
A beautiful library with a dream ship out front.

>e
21st & Forest
You are at a traffic circle to the east of the library.

>n
21st & Bayview
You are at a nice traffic circle. An inviting sidewalk beckons to the south.

>ne
Front Yard

>e
Front Porch
You can see a front door and a mailbox (in which is an envelope (in which is a letter)) here.

* * *

>n
Kitchen
You can see a back door, a stove (on which is a pot) and a fridge (closed) here.

>open door
You open the back door.

>e
Back Yard
You are standing in the grass next to an inviting trampoline.

You can see a back door, a trampoline (closed) and a toy yellow dump truck here.

>x trampoline
A big rectangular trampoline with a safety net around it. You can open it and bounce on it.

>open trampoline
You open the trampoline.

>bounce
What do you want to bounce on?

>bounce on trampoline
You jump on the trampoline and bounce up and down. Whee!

Back Yard (in the trampoline)
You are standing in the grass next to an inviting trampoline.

You can see a back door and a toy yellow dump truck here.

>l
Back Yard (in the trampoline)
You are standing in the grass next to an inviting trampoline.

You can see a back door and a toy yellow dump truck here.

>x truck
You notice a jubilant egg in the bed of the toy yellow dump truck!

>exit trampoline
I only understood you as far as wanting to exit.

>leave trampoline
I only understood you as far as wanting to leave.

>w
You would have to get out of the trampoline first.

>get out of trampoline
Back Yard
You are standing in the grass next to an inviting trampoline.

You can see a back door, a trampoline (empty) and a toy yellow dump truck (on which is a jubilant egg) here.

You triple backflip out of the the trampoline. Cowabunga!

* * *

>n
Kitchen
You can see a back door, a stove (on which is a pot) and a fridge (closed) here.

>w
Dining Room
You can see a table (on which is an utensil holder) and a cupboard (closed) here.

* * *

>open door
You open the front door.

>w
Front Porch
You are on a wooden front porch.

You can see a front door and Smith Brothers milk crate (closed) here.

>sw
You can't go that way.

>w
Front Yard
A nice front yard with a yellow fire hydrant.

You can see a mailbox (closed) here.

>sw
21st & Bayview
You are at a nice traffic circle. An inviting sidewalk beckons to the south.

You can see a flower bed here.

>get egg
You don't see any such thing.

>undo
21stBayview
[Previous turn undone.]

>get egg
You don't see any such thing.

>x bed
You notice a pink egg between the plants!

>get it
That's fixed in place.

>get egg
Taken.

* * *

>sw
21st & Bayview
You are at a nice traffic circle. An inviting sidewalk beckons to the south.

You can see a flower bed here.

>s
20thForest
You are at a traffic circle to the east of the library. A path also leads southeast.

You can see a traffic circle here.

>n
21st & Bayview
You are at a nice traffic circle. An inviting sidewalk beckons to the south.

You can see a flower bed here.

* * *

>sw
21st & Bayview
You are at a nice traffic circle. An inviting sidewalk beckons to the south.

You can see a flower bed here.

>x bed
You notice a pink egg between the plants!

>get egg
Taken.

* * *

>w
Front Porch
You are on a wooden front porch.

You can see a front door and Smith Brothers milk crate (closed) here.

>w
Front Yard
A nice front yard with a yellow fire hydrant.

You can see a mailbox (closed) here.

>sw
21stBayview
You are at a nice traffic circle. An inviting sidewalk beckons to the south.

You can see a flower bed here.

>examine bed
You notice a pink egg between the plants!

>get egg
Taken.

>open egg
It isn't something you can open.

>showme egg
(the pink egg)
pink egg - thing
location: carried by yourself in 21stBayview
unlit, inedible, portable, handled; singular-named, improper-named
description: none
initial appearance: none
printed name: "pink egg"
printed plural name: none
indefinite article: none
list grouping key: none

* * *

>sw
21stBayview
You are at a nice traffic circle. An inviting sidewalk beckons to the south.

You can see a flower bed here.

>s
20thForest
You are at a traffic circle to the east of the library. A path also leads southeast.

You can see a traffic circle here.

>se
22ndStevens
Great looking traffic circle on 22nd.

>s
The Bowl
A dip in the street from all directions, looks like an interesting place to ride a bike.

You can see Base of street sign here.

>w
Arrow Bench
An attractive spot with a beautiful wooden bench in the shape of an arrow.

You can see under the bench here.

>x under bench
You notice a spotted egg under the bench!

>get egg
Taken.

>showme spotted egg
spotted egg - thing
location: carried by yourself in Arrow Bench
unlit, inedible, portable, handled; singular-named, improper-named
description: none
initial appearance: none
printed name: "spotted egg"
printed plural name: none
indefinite article: none
list grouping key: none

>w
National Park
You look out toward the Cascades.  What a view! There is a low wall here.

You can see behind the wall here.

>x behind wall
You notice a fuchsia egg behind the wall!

>sw
Firehouse
A lovely old firehouse from 1930 with a story illustrated on rocks out front.

You can see three raised tree boxes here.

>x boxes
You notice a teal egg in the middle tree box!

>get it
That's fixed in place.

>get egg
(the teal egg)
Taken.

>n
Library
A beautiful library with a dream ship out front.

You can see a spring poem here.

>x poem
You notice a mauve egg lying beside the spring poem!

>get egg
(the mauve egg)
Taken.

* * *

>s
20thForest
You are at a traffic circle to the east of the library. A path also leads southeast.

You can see a traffic circle here.

>x circle
You notice a happy egg in the traffic circle!

>get egg
Taken.

>se
22ndStevens
Great looking traffic circle on 22nd. The road bends down to the south.

You can see some scrubby plants here.

>x plants
You notice a perplexed egg in the scrubby plants!

>get egg
(the perplexed egg)
Taken.

>i
You are carrying:
  a perplexed egg
  a happy egg

* * *

>w
Front Yard
A nice front yard with a yellow fire hydrant.

You can see a mailbox (closed) here.

>x hydrant
The diminutive yellow plug stands tall, ready to do its job.

* * *

>w
Front Room
You can see a front door, a rack (on which is a coat) and a bin (closed) here.

>open it
You open the bin, revealing a purple Easter egg.

* * *

>w
Bonk! The front door is closed.

>open it
You open the bin, revealing a purple Easter egg.

>open door
You open the front door.

* * *

>w
Front Yard

>ne
You can't go that way.

>sw
21st & Bayview

* * *

>d
Living Room
There are big windows here and a comfy looking recliner. You can go up, northwest, north, or west into the garage.

You can see a garage door, a couch and a footrest (closed) here.

>open door
You open the garage door.

>examine safe
You can't see any such thing.

>l
Living Room
You can see a garage door, a couch and a footrest (closed) here.

>w
Garage
You can see a garage door and a safe (closed) here.

>x safe
You haven't dialed the safe to any combination yet.

>set dial to 2
You can't see any such thing.

>set safe to 2
You dial 2 on the safe.

>set safe to 10
You dial 10 on the safe.

>set safe to 11
You dial 11, and the safe gives a joyous CLICK.

>open safe
You open the safe, revealing some paper.

* * *

>open door
You open the garage door.

>w
Garage
You are in a two car garage with a really high ceiling.  There is a weight bench here and an extremely heavy looking kettlebell.

You can see a garage door and a safe (closed) here.

>examine kettlebell
It's a massive cast iron ball with a handle.

>examine weight bench
A padded black vinyl surface covers the bench. It has wheels on one end.

>purloin mauve egg
[Purloined.]

>i
You are carrying:
  a mauve egg

>e
Living Room
There are big windows here and a comfy looking recliner. You can go up, northwest, north, or west into the garage.

You can see a garage door, a couch and a footrest (closed) here.

>u
Bedroom
The master bedroom is tastefully furnished and has a vaulted ceiling. You can exit by going down.

You can see a bed (on which is a pillow) and a blue backpack (closed) here.

>open backpack
You open the blue backpack, revealing a red Easter egg.

>get egg
(the red Easter egg)
[Your score has just gone up by ten points.]

>drop egg
Which do you mean, the red Easter egg or the mauve egg?

>drop reg egg
You can't see any such thing.

>drop red egg
Dropped.

>get red egg
Taken.

>drop red egg
Dropped.

* * *

>get red egg
Taken.

>l
Bedroom
The master bedroom is tastefully furnished and has a vaulted ceiling. You can exit by going down.

You can see a bed (on which is a pillow) and a blue backpack (empty) here.

>gonear arrow
Arrow Bench
An attractive spot shaded by a few short but dedicated trees. There is a wooden bench shaped like an arrow.  Some steps leads up to the west, or you can go east.

You can see under the bench here.

>gonear spotted egg
Arrow Bench
An attractive spot shaded by a few short but dedicated trees. There is a wooden bench shaped like an arrow.  Some steps leads up to the west, or you can go east.

You can see under the bench here.

>gonear green egg
Living Room
There are big windows here and a comfy looking recliner. You can go up, northwest, north, or west into the garage.

You can see a garage door, a couch and a footrest (closed) here.

>showme spotted egg
spotted egg - thing
location: on under the bench in Arrow Bench
unlit, inedible, portable; singular-named, improper-named
description: none
initial appearance: none
printed name: "spotted egg"
printed plural name: none
indefinite article: none
list grouping key: none

>gonear arrow
Arrow Bench
An attractive spot shaded by a few short but dedicated trees. There is a wooden bench shaped like an arrow.  Some steps leads up to the west, or you can go east.

You can see under the bench here.

>look under the bench
You notice a spotted egg under the bench!

* * *

>w
Garage
You are in a two car garage with a really high ceiling.  There is a weight bench here and an extremely heavy looking kettlebell.

You can see a garage door and a safe (closed) here.

>x kettlebell
You can't see any such thing.

* * *

>d
Living Room
There are big windows here and a comfy looking recliner. You can go up, northwest, north, or west into the garage.

You can see a garage door, a couch and a footrest (closed) here.

>u
Bedroom
The master bedroom is tastefully furnished and has a vaulted ceiling. You can exit by going down.

You can see a bed (on which is a pillow) and a nightstand (closed) here.

* * *

>d
Living Room
There are big windows here and a comfy looking recliner. You can go up, northwest, north, or west into the garage.

You can see a garage door, a couch and a footrest (closed) here.

>w
Bonk! The garage door is closed.

>e
Living Room
You can see a couch and a footrest (closed) here.

>w
Garage
You can see a safe (closed) here.

>close door
You close the garage door.

>e
(first opening the garage door)

Living Room
You can see a couch and a footrest (closed) here.

* * *

>w
Bonk! The garage door is closed.

>n
Kitchen
You can see a back door, a stove (on which is a pot) and a fridge (closed) here.

* * *

>open door
You open the front door.

>w
Front Porch
You are on a wooden front porch next to a Smith Brothers milk crate.

You can see a front door and a mailbox (in which is an envelope (in which is a letter)) here.

>w
Front Yard
A nice front yard with a yellow fire hydrant.

>sw
21stBayview
You are at a nice traffic circle. An inviting sidewalk beckons to the south.

You can see a flower bed here.

>s
20thForest
You are at a traffic circle to the east of the library.

>se
22ndStevens
Great looking traffic circle on 22nd.

* * *

>s
The Bowl
A dip in the street from all directions, looks like an interesting place to ride a bike.

You can see Base of street sign here.

>x base
You notice a turquoise egg at the bottom of the pole!

>get egg
Taken.

>open it
It isn't something you can open.

>open egg
It isn't something you can open.

* * *

>sw
21stBayview
You are at a nice traffic circle. An inviting sidewalk beckons to the south.

You can see a flower bed here.

>x bed
You notice a pink egg between the plants!

* * *

>get egg
Taken.

>undo
21stBayview
[Previous turn undone.]

>l
21stBayview
You are at a nice traffic circle. An inviting sidewalk beckons to the south.

You can see a flower bed here.

>undo
21stBayview
[Previous turn undone.]

>undo
21stBayview
[Previous turn undone.]

>undo
Front Yard
[Previous turn undone.]

>sw
21stBayview
You are at a nice traffic circle. An inviting sidewalk beckons to the south.

You can see a flower bed here.

>take egg
Taken.

>undo
21stBayview
[Previous turn undone.]

>x bed
You notice a pink egg between the plants!

* * *

>w
Bonk! The garage door is closed.

>w
Bonk! The garage door is closed.

>l
Garage

>examine safe
It's a small safe, about a cubic foot, with a keypad on the front, laid out the same as a cellphone keypad.

>type 123 on keypad
You don't know how to do that to nothing.

>type 73836
(on the safe)
You don't know how to do that to nothing.

>type 73836 on safe
You don't know how to do that to nothing.

* * *

>w
Bonk! The garage door is closed.

>open door
You open the garage door.

>w
Garage
You can see a garage door and a safe (closed) here.

>e
Living Room
You can see a garage door, a couch and a footrest (closed) here.

>n
Kitchen
You can see a stove (on which is a pot) and a fridge (closed) here.

I beg your pardon?

>w
Dining Room
You can see a table (on which is an utensil holder) and a cupboard (closed) here.

* * *

>w
Front Porch
You can see a front door and a mailbox (in which is an envelope (in which is a letter)) here.

>get letter
Taken.

>read it
You see nothing special about the letter.

>e
Front Room
You can see a front door, a rack (on which is a coat) and a bin (closed) here.

* * *

>e
Dining Room
You can see a table (on which is an utensil holder) and a cupboard (closed) here.

>e
Kitchen
You can see a stove (on which is a pot) and a fridge (closed) here.

>s
Living Room
You can see a garage door, a couch and a footrest (closed) here.

>w
Garage
You can see a garage door and a safe (closed) here.

>w
You can't go that way.

>close door
You close the garage door.

>e
Bonk! The garage door is closed.

>open it
You open the garage door.

>x safe
You haven't dialed the safe to any combination yet.

* * *

>open safe
You open the safe, revealing some paper.

>get paper
Taken.

>read it
You have dialed the safe to 2, 10 and 11.

>read paper
You read the message on the paper: .-… - - -.- / … -. / - .-. … … - .- -. … / -.-. .-… - … . -

* * *

>w
Bonk! The garage door is closed.

>x safe
You haven't dialed the safe to any combination yet.

>set safe to 10
You dial 10 on the safe.

>x safe
You have dialed the safe to 10.

>set safe to 29
You dial 29 on the safe.

>x safe
You have dialed the safe to 10 and 29.

>set safe to 2
You dial 2 on the safe.

>x safe
You have dialed the safe to 10, 29 and 2.

>set safe to 10
You dial 10 on the safe.

>x safe
You have dialed the safe to 29, 2 and 10.

>set safe to 11
You dial 11, and the safe gives a joyous CLICK.

* * *

>get paper
Taken.

>set safe to 14
You dial 14 on the safe.

>close safe
You close the safe.

>set safe to 10
You spin the dial, and the safe snicks locked.

>x safe
You have dialed the safe to 11, 14 and 10.

>read paper
You read the message on the paper: "Message placeholder."

>restart
Are you sure you want to restart?

>y
The Great Beacon Hill Egg Hunt
An Interactive Fiction by E. Bunny
Release 1 / Serial number 230306 / Inform 7 v10.1.2 / D

Bedroom
The master bedroom is tastefully furnished and has a vaulted ceiling. You can exit by going down.

You can see a bed (on which is a pillow) and a nightstand (closed) here.

>d
Living Room
You can see a couch and a footrest (closed) here.

>w
garage door

* * *

The Great Beacon Hill Egg Hunt
An Egg-stravagant Fiction by E. Bunny
Release 1 / Serial number 230412 / Inform 7 v10.1.2 / D

Bedroom
The master bedroom is tastefully furnished and has a vaulted ceiling. You can exit by going down, west, or east.

You can see a bed (on which is a pillow) and a blue backpack (closed) here.

>get backpack
Taken.

>open backpack
You open the blue backpack, revealing a red Easter egg.

>get egg
[Your score has just gone up by ten points.]

>open egg
You open the red Easter egg, revealing a message.

>read message
The message says "Find us in the real world."

* * *

>get backpack
Taken.

>open it
You open the blue backpack, revealing a red Easter egg.

>get egg
[Your score has just gone up by ten points.]

>w
Hallway
A hallway that you thought you'd seen many times before, but something seems to be different about it this time.

You can see a washing machine (on which is a dryer) here.

>examine portal
You can't see any such thing.

>n
You can't go that way.

>s
You can't go that way.

>open portal
You can't see any such thing.

>e
Bedroom
The master bedroom is tastefully furnished and has a vaulted ceiling. You can exit by going down or west.

You can see a bed (on which is a pillow) here.

>d
Living Room
There are big windows here and a comfy looking recliner. You can go up, northwest, north, or west into the garage.

You can see a garage door, a couch and a footrest (closed) here.

>n
Kitchen
Granite countertops adorn this small kitchen. You can see the back yard outside a door to the east and a dining room to the west. 

You can see a back door, a stove (on which is a pot) and a fridge (closed) here.

>w
Dining Room
A cozy eating nook with a chandelier hanging from the ceiling, it features a simple wooden table and four chairs. Exits lead east and west.

You can see a table (on which is an utensil holder) and a cupboard (closed) here.

>w
Front Room
The front entry room of the house. An attractive blue rug adds to the warmth. Out the window is a beautiful city skyline.

You can see a front door, a rack (on which is a coat), a black bin (closed) and a hamper (closed) here.

* * *

The Great Beacon Hill Egg Hunt
An Egg-stravagant Fiction by E. Bunny
Release 1 / Serial number 230412 / Inform 7 v10.1.2 / D

Bedroom
The master bedroom is tastefully furnished and has a vaulted ceiling. You can exit by going down, west, or east.

You can see a bed (on which is a pillow) and a blue backpack (closed) here.

>get pillow
Taken.

>i
You are carrying:
  a pillow

>examine pillow
You see nothing special about the pillow.

>examine nights
You can't see any such thing.

>examine nightst
You can't see any such thing.

>examine nightsta
You can't see any such thing.

>examine nightstan
You see nothing special about the nightstand.

>open nightstand
You open the nightstand, revealing a red Easter egg.

>i
You are carrying:
  a pillow

>get egg
Taken.

>throw pillow
Dropped.

>l
Bedroom
You can see a pillow, a bed and a nightstand (empty) here.

* * *

The Great Beacon Hill Egg Hunt
An Egg-stravagant Fiction by E. Bunny
Release 1 / Serial number 230412 / Inform 7 v10.1.2 / D

Bedroom
The master bedroom is tastefully furnished and has a vaulted ceiling. You can exit by going down, west, or east.

You can see a bed (on which is a pillow) and a blue backpack (closed) here.

>gonear 20thforest
20th & Forest
You are at a traffic circle to the east of the library. A path also leads southeast.

You can see a traffic circle here.

* * *

The Great Beacon Hill Egg Hunt
An Egg-stravagant Fiction by E. Bunny
Release 1 / Serial number 230412 / Inform 7 v10.1.2 / D

Bedroom
The master bedroom is tastefully furnished and has a vaulted ceiling. You can exit by going down, west, or east.

You can see a bed (on which is a pillow) and a blue backpack (closed) here.

>gonear arrow
Arrow Bench
An attractive spot shaded by a few short but dedicated trees. There is a wooden bench shaped like an arrow.

You can see under the bench here.

>showme spotted egg
spotted egg - thing
location: out of play
unlit, inedible, portable; singular-named, improper-named
description: "A spotted egg with a ribbon around it. It looks like someone hid it here for you to find."
initial appearance: none
printed name: "spotted egg"
printed plural name: none
indefinite article: none
list grouping key: none

>look under bench
You bend down and find a spotted egg under the bench!

>get egg
You already have that.

>get spotted egg
You already have that.

>i
You are carrying:
  a spotted egg

* * *

>gonear arrow
Arrow Bench
An attractive spot shaded by a few short but dedicated trees. There is a wooden bench shaped like an arrow.

You can see under the bench here.

>x bench
You notice a spotted egg under the bench!

>get egg
[Your score has just gone up by ten points.]

>i
You are carrying:
  a spotted egg

* * *

>x bench
You notice a spotted egg under the bench!

>look under bench
You bend down and notice a spotted egg under the bench!

>get egg
[Your score has just gone up by ten points.]

>showme spotted egg
spotted egg - thing
location: out of play
unlit, inedible, portable; singular-named, improper-named
description: "A spotted egg with a ribbon around it. It looks like someone hid it here for you to find."
initial appearance: none
printed name: "spotted egg"
printed plural name: none
indefinite article: none
list grouping key: none

* * *

The Great Beacon Hill Egg Hunt
An Egg-stravagant Fiction by E. Bunny
Release 1 / Serial number 230412 / Inform 7 v10.1.2 / D

Bedroom
The master bedroom is tastefully furnished and has a vaulted ceiling. You can exit by going down, west, or east.

You can see a bed (on which is a pillow) and a blue backpack (closed) here.

>gonear bench
Arrow Bench
An attractive spot shaded by a few short but dedicated trees.

You can see a bench here.

>gonear the bench
Which do you mean, the bench or Arrow Bench?

* * *

>gonear bench
Arrow Bench
An attractive spot shaded by a few short but dedicated trees.

You can see a bench here.

>x bench
A beautiful wooden bench in the shape of an arrow beckons you. You notice something under it.

>look under bench
You bend down and find a spotted egg under the bench!

>get egg
You can't see any such thing.

>showme spotted egg
spotted egg - thing
location: out of play
unlit, inedible, portable; singular-named, improper-named
description: "A spotted egg with a ribbon around it. It looks like someone hid it here for you to find."
initial appearance: none
printed name: "spotted egg"
printed plural name: none
indefinite article: none
list grouping key: none

>get foo
You can't see any such thing.

>showme red egg
red Easter egg - closed container
    message
location: in the nightstand in the Bedroom
unlit, inedible, portable; opaque, closed, openable, unlocked; singular-named, improper-named
description: none
initial appearance: none
carrying capacity: 100
printed name: "red Easter egg"
printed plural name: "containers"
indefinite article: none
list grouping key: none

>showme spotted egg
spotted egg - thing
location: out of play
unlit, inedible, portable; singular-named, improper-named
description: "A spotted egg with a ribbon around it. It looks like someone hid it here for you to find."
initial appearance: none
printed name: "spotted egg"
printed plural name: none
indefinite article: none
list grouping key: none

>showme blue egg
blue Easter egg - thing
location: in the fridge in Kitchen
unlit, inedible, portable; singular-named, improper-named
description: none
initial appearance: none
printed name: "blue Easter egg"
printed plural name: none
indefinite article: none
list grouping key: none

* * *

>showme spotted egg
spotted egg - thing
location: out of play
unlit, inedible, portable; singular-named, improper-named
description: "A spotted egg with a ribbon around it. It looks like someone hid it here for you to find."
initial appearance: none
printed name: "spotted egg"
printed plural name: none
indefinite article: none
list grouping key: none

>showme red egg
red Easter egg - closed container
    message
location: in the nightstand in the Bedroom
unlit, inedible, portable; opaque, closed, openable, unlocked; singular-named, improper-named
description: none
initial appearance: none
carrying capacity: 100
printed name: "red Easter egg"
printed plural name: "containers"
indefinite article: none
list grouping key: none

>gonear red egg
Bedroom
The master bedroom is tastefully furnished and has a vaulted ceiling. You can exit by going down.

You can see a bed (on which is a pillow) and a nightstand (closed) here.

>open nightstand
You open the nightstand, revealing a red Easter egg.

>get egg
[Your score has just gone up by ten points.]

>showme red egg
red Easter egg - closed container
    message
location: carried by yourself in the Bedroom
unlit, inedible, portable, handled; opaque, closed, openable, unlocked; singular-named, improper-named
description: none
initial appearance: none
carrying capacity: 100
printed name: "red Easter egg"
printed plural name: "containers"
indefinite article: none
list grouping key: none

* * *

>get egg
You can't see any such thing.

>x bench
A beautiful wooden bench in the shape of an arrow beckons you. You notice something under it.

>l
Arrow Bench
An attractive spot shaded by a few short but dedicated trees.

You can see a bench here.

* * *

>look under bench
You bend down and find a spotted egg under the bench!

>get it
Taken.

>i
You are carrying:
  a bench

* * *

The Great Beacon Hill Egg Hunt
An Egg-stravagant Fiction by E. Bunny
Release 1 / Serial number 230412 / Inform 7 v10.1.2 / D

Bedroom
The master bedroom is tastefully furnished and has a vaulted ceiling. You can exit by going down, west, or east.

You can see a bed (on which is a pillow) and a blue backpack (closed) here.

>gonear happy egg
20thForest
You are at a traffic circle to the east of the library. A path also leads southeast.

You can see a traffic circle here.

* * *

The Great Beacon Hill Egg Hunt
An Egg-stravagant Fiction by E. Bunny
Release 1 / Serial number 230412 / Inform 7 v10.1.2 / D

Bedroom
The master bedroom is tastefully furnished and has a vaulted ceiling. You can exit by going down, west, or east.

You can see a bed (on which is a pillow) and a blue backpack (closed) here.

>l
Bedroom
The master bedroom is tastefully furnished and has a vaulted ceiling. You can exit by going down.

You can see a bed (on which is a pillow) and a blue backpack (closed) here.

* * *

The Great Beacon Hill Egg Hunt
An Egg-stravagant Fiction by E. Bunny
Release 1 / Serial number 230412 / Inform 7 v10.1.2 / D

Bedroom
The master bedroom is tastefully furnished and has a vaulted ceiling. You can exit by going down, west, or east.

You can see a bed (on which is a pillow) and a blue backpack (closed) here.

>open backpack
You open the blue backpack, revealing a red Easter egg.

>take easter egg
[Your score has just gone up by ten points.]

>look under pillow
You find nothing of interest.

>look under bed
You find nothing of interest.

>go down
Living Room
There are big windows here and a comfy looking recliner. You can go up, northwest, or north.

You can see a garage door, a couch and a footrest (closed) here.

>open footrest
You open the footrest, revealing a green Easter egg.

>take Easter egg
(the green Easter egg)
[Your score has just gone up by ten points.]

>open garage door
You open the garage door.

>nw
Bathroom
You can see yourself in a big mirror here. There is an exit to the southeast.

You can see a sink (on which is a bar of soap) and a cabinet (closed) here.

* * *

The Great Beacon Hill Egg Hunt
An Egg-stravagant Fiction by E. Bunny
Release 1 / Serial number 230412 / Inform 7 v10.1.2 / D

Bedroom
The master bedroom is tastefully furnished and has a vaulted ceiling. You can exit by going down, west, or east.

You can see a bed (on which is a pillow) and a blue backpack (closed) here.

>open nightsta
You can't see any such thing.

>open nightstad
You can't see any such thing.

>open nightstand
You open the nightstand, revealing a red Easter egg.

>get egg
Taken.

>open egg
You open the red Easter egg, revealing nothing.

>undo
Bedroom
[Previous turn undone.]

>rules
Rules tracing now switched on. Type "rules off" to switch it off again, or "rules all" to include even rules which do not apply.

[Rule "parse command rule" applies.]

>open egg
[Rule "declare everything initially unmentioned rule" applies.]
[Rule "generate action rule" applies.]
[Rule "announce items from multiple object lists rule" applies.]
[Rule "set pronouns from items from multiple object lists rule" applies.]
[Rule "before stage rule" applies.]
[Rule "basic visibility rule" applies.]
[Rule "basic accessibility rule" applies.]
[Rule "access through barriers rule" applies.]
[Rule "carrying requirements rule" applies.]
[Rule "instead stage rule" applies.]
[Rule "requested actions require persuasion rule" applies.]
[Rule "carry out requested actions rule" applies.]
[Rule "descend to specific action-processing rule" applies.]
[Rule "work out details of specific action rule" applies.]
[Rule "investigate player's awareness before action rule" applies.]
[Rule "player aware of his own actions rule" applies.]
[Rule "check stage rule" applies.]
[Rule "can't open unless openable rule" applies.]
[Rule "can't open what's locked rule" applies.]
[Rule "can't open what's already open rule" applies.]
[Rule "carry out stage rule" applies.]
[Rule "standard opening rule" applies.]
[Rule "after stage rule" applies.]
[Rule "investigate player's awareness after action rule" applies.]
[Rule "report stage rule" applies.]
[Rule "reveal any newly visible interior rule" applies.]
You open the red Easter egg, revealing nothing.
[Rule "last specific action-processing rule" applies.]

[Rule "A first turn sequence rule" applies.]
[Rule "scene change machinery rule" applies.]
[Rule "every turn stage rule" applies.]
[Rule "timed events rule" applies.]
[Rule "advance time rule" applies.]
[Rule "update chronological records rule" applies.]
[Rule "A last turn sequence rule" applies.]
[Rule "scene change machinery rule" applies.]
[Rule "adjust light rule" applies.]
[Rule "note object acquisitions rule" applies.]
[Rule "notify score changes rule" applies.]
[Rule "parse command rule" applies.]

* * *

The Great Beacon Hill Egg Hunt
An Egg-stravagant Fiction by E. Bunny
Release 1 / Serial number 230412 / Inform 7 v10.1.2 / D

Bedroom
The master bedroom is tastefully furnished and has a vaulted ceiling. You can exit by going down, west, or east.

You can see a bed (on which is a pillow) and a blue backpack (closed) here.

>open nightstan
You open the nightstand, revealing a red Easter egg.

>get egg
Taken.

>open it
You open the red Easter egg, revealing nothing.

>undo
Bedroom
[Previous turn undone.]

>open egg
You open the red Easter egg, revealing nothing.

* * *

The Great Beacon Hill Egg Hunt
An Egg-stravagant Fiction by E. Bunny
Release 1 / Serial number 230412 / Inform 7 v10.1.2 / D

Bedroom
The master bedroom is tastefully furnished and has a vaulted ceiling. You can exit by going down, west, or east.

You can see a bed (on which is a pillow) and a blue backpack (closed) here.

>open nightstand
You open the nightstand, revealing a red Easter egg.

* * *

>get egg
Taken.

>d
Living Room
You can see a couch and a footrest (closed) here.

>open footrest
You open the footrest, revealing a green Easter egg.

>get egg
(the green Easter egg)
Taken.

>w
garage door
There is a magical trunk on the floor. The box has a combination lock on it.

>w
Garage
You can see a magical trunk (closed) here.

>open trunk
It seems to be locked.

>unlock trunk
What do you want to unlock the magical trunk with?

>examine lock
A simple dial with numbers from 0 to 9. You can turn it left or right to enter a code.

>Enter 579
You can't see any such thing.

>Turn dial to 579
You can't see any such thing.

>Turn combination lock to 579
I only understood you as far as wanting to turn the combination lock.

>Turn code entry to 579
You can't see any such thing.

>kick trunk
That's not a verb I recognise.

>scream
That's not a verb I recognise.

>shit
That's not a verb I recognise.

>examine trunk
A sturdy magical trunk with a three-digit combination lock on it. Maybe there is something inside.

>Turn combination lock to 579
I only understood you as far as wanting to turn the combination lock.

I beg your pardon?

>e
garage door
There is a magical trunk on the floor. The box has a combination lock on it.

>e
Living Room
You can see a couch and a footrest (empty) here.

>n
Kitchen
You can see a stove (on which is a pot) and a fridge (closed) here.

>open fridge
You open the fridge, revealing a blue Easter egg.

>get egg
(the blue Easter egg)
Taken.

>i
You are carrying:
  a blue Easter egg
  a green Easter egg
  a red Easter egg

>w
Dining Room
You can see a table (on which is an utensil holder) and a cupboard (closed) here.

>open cupboard
You open the cupboard, revealing an orange Easter egg.

>get egg
(the orange Easter egg)
Taken.

>i
You are carrying:
  an orange Easter egg
  a blue Easter egg
  a green Easter egg
  a red Easter egg

>l
Dining Room
You can see a table (on which is an utensil holder) and a cupboard (empty) here.

>w
Front Room
You can see a rack (on which is a coat) and a bin (closed) here.

>open bin
You open the bin, revealing a purple Easter egg.

>get egg
(the purple Easter egg)
Taken.

>i
You are carrying:
  a purple Easter egg
  an orange Easter egg
  a blue Easter egg
  a green Easter egg
  a red Easter egg

>w
front door
It leads outside.

>w
Front Porch
You can see a mailbox (in which is an envelope (in which is a letter)) here.

>open mailbox
It isn't something you can open.

>get letter
Taken.

* * *

>read it
You see nothing special about the letter.

>e
front door
It leads outside.

>e
Front Room
You can see a rack (on which is a coat) and a bin (empty) here.

>e
Dining Room
You can see a table (on which is an utensil holder) and a cupboard (empty) here.

>e
Kitchen
You can see a stove (on which is a pot) and a fridge (empty) here.

>s
Living Room
You can see a couch and a footrest (empty) here.

>nw
Bathroom
You can see a sink (on which is a bar of soap) and a cabinet (closed) here.

>open cabinet
You open the cabinet, revealing a yellow Easter egg.

>get egg
(the yellow Easter egg)
Taken.

>i
You are carrying:
  a yellow Easter egg
  a letter
  a purple Easter egg
  an orange Easter egg
  a blue Easter egg
  a green Easter egg
  a red Easter egg

* * *

>get egg
Taken.

>open egg
You open the red Easter egg, revealing a message.

>read message
The message says "Find me in the real world."

>d
Living Room
You can see a garage door, a couch and a footrest (closed) here.

>open footrest
You open the footrest, revealing a green Easter egg.

* * *

>get egg
(the green Easter egg)
Taken.

>n
Kitchen
You can see a back door, a stove (on which is a pot) and a fridge (closed) here.

>open fridge
You open the fridge, revealing a blue Easter egg.

* * *

>get egg
(the blue Easter egg)
Taken.

>w
Dining Room
You can see a table (on which is an utensil holder) and a cupboard (closed) here.

* * *

>get egg
(the orange Easter egg)
Taken.

>w
Front Room
You can see a front door, a rack (on which is a coat) and a bin (closed) here.

>open bin
You open the bin, revealing a purple Easter egg.

* * *

>get egg
(the purple Easter egg)
Taken.

>open door
You open the front door.

* * *

>w
Front Yard
A nice front yard with a yellow fire hydrant.

You can see a mailbox (closed) here.

>open mailbox
You open the mailbox, revealing an envelope.

>get envelope
Taken.

>x envelope
You see nothing special about the envelope.

>open it
You open the envelope, revealing a letter.

>read letter
Happy Easter! Love, E.B.

>sw
21stBayview
You are at a nice traffic circle. An inviting sidewalk beckons to the south.

You can see a flower bed here.

* * *

>x bed
You notice a pink egg between the plants!

>get egg
(the pink egg)
Taken.

>i
You are carrying:
  a pink egg
  an envelope (open)
    a letter
  a purple Easter egg
  an orange Easter egg
  a blue Easter egg
  a green Easter egg
  a red Easter egg (open)
    a message

>drop letter
You haven't got that.

>drop envelope
Dropped.

>i
You are carrying:
  a pink egg
  a purple Easter egg
  an orange Easter egg
  a blue Easter egg
  a green Easter egg
  a red Easter egg (open)
    a message

>get message
Taken.

>drop message
Dropped.

>i
You are carrying:
  a pink egg
  a purple Easter egg
  an orange Easter egg
  a blue Easter egg
  a green Easter egg
  a red Easter egg (open but empty)

>l
21stBayview
You are at a nice traffic circle. An inviting sidewalk beckons to the south.

You can see a message, an envelope (in which is a letter) and a flower bed here.

>x bed
You notice a pink egg between the plants!

>get egg
Which do you mean, the pink egg, the purple Easter egg, the orange Easter egg, the blue Easter egg, the green Easter egg or the red Easter egg?

>pink
You already have that.

>s
20thForest
You are at a traffic circle to the east of the library. A path also leads southeast.

You can see a traffic circle here.

* * *

>x circle
You notice a happy egg in the traffic circle!

>get egg
(the happy egg)
Taken.

>se
22ndStevens
Great looking traffic circle on 22nd. The road bends down to the south.

You can see some scrubby plants here.

* * *

>get egg
(the perplexed egg)
Taken.

>s
The Bowl
A dip in the street from all directions, looks like an interesting place to ride a bike.

You can see Base of street sign here.

>x sign
You notice a turquoise egg at the bottom of the pole!

>get egg
(the turquoise egg)
Taken.

>w
Arrow Bench
An attractive spot with a beautiful wooden bench in the shape of an arrow.

You can see under the bench here.

>x bench
You notice a spotted egg under the bench!

>get egg
(the spotted egg)
Taken.

>w
National Park
You look out toward the Cascades.  What a view! There is a low wall here.

You can see behind the wall here.

>x wall
You notice a fuchsia egg behind the wall!

>get egg
(the fuchsia egg)
Taken.

>sw
Firehouse
A lovely old firehouse from 1930 with a story illustrated on rocks out front.

You can see three raised tree boxes here.

* * *

>x boxes
You notice a teal egg in the middle tree box!

>get egg
(the teal egg)
Taken.

* * *

>get egg
(the mauve egg)
Taken.

>e
20thForest
You are at a traffic circle to the east of the library. A path also leads southeast.

You can see a traffic circle here.

>n
21stBayview
You are at a nice traffic circle. An inviting sidewalk beckons to the south.

You can see a message, an envelope (in which is a letter) and a flower bed here.

>ne
Front Yard
A nice front yard with a yellow fire hydrant.

You can see a mailbox (empty) here.

>e
Front Porch
You are on a wooden front porch.

You can see a front door and Smith Brothers milk crate (closed) here.

>e
Front Room
You can see a front door, a rack (on which is a coat) and a bin (empty) here.

>i
You are carrying:
  a mauve egg
  a teal egg
  a fuchsia egg
  a spotted egg
  a turquoise egg
  a perplexed egg
  a happy egg
  a pink egg
  a purple Easter egg
  an orange Easter egg
  a blue Easter egg
  a green Easter egg
  a red Easter egg (open but empty)

>e
Dining Room
You can see a table (on which is an utensil holder) and a cupboard (empty) here.

>e
Kitchen
You can see a back door, a stove (on which is a pot) and a fridge (empty) here.

>s
Living Room
You can see a garage door, a couch and a footrest (empty) here.

>nw
Bathroom
You can see a sink (on which is a bar of soap) and a cabinet (closed) here.

* * *

>get egg
(the yellow Easter egg)
Taken.

>i
You are carrying:
  a yellow Easter egg
  a mauve egg
  a teal egg
  a fuchsia egg
  a spotted egg
  a turquoise egg
  a perplexed egg
  a happy egg
  a pink egg
  a purple Easter egg
  an orange Easter egg
  a blue Easter egg
  a green Easter egg
  a red Easter egg (open but empty)

>se
Living Room
You can see a garage door, a couch and a footrest (empty) here.

>n
Kitchen
You can see a back door, a stove (on which is a pot) and a fridge (empty) here.

>w
Dining Room
You can see a table (on which is an utensil holder) and a cupboard (empty) here.

>w
Front Room
You can see a front door, a rack (on which is a coat) and a bin (empty) here.

>w
Front Porch
You are on a wooden front porch.

You can see a front door and Smith Brothers milk crate (closed) here.

>open crate
You open Smith Brothers milk crate, revealing a joyful Easter egg.

>get egg
(the joyful Easter egg)
Taken.

>i
You are carrying:
  a joyful Easter egg
  a yellow Easter egg
  a mauve egg
  a teal egg
  a fuchsia egg
  a spotted egg
  a turquoise egg
  a perplexed egg
  a happy egg
  a pink egg
  a purple Easter egg
  an orange Easter egg
  a blue Easter egg
  a green Easter egg
  a red Easter egg (open but empty)

>e
Front Room
You can see a front door, a rack (on which is a coat) and a bin (empty) here.

>e
Dining Room
You can see a table (on which is an utensil holder) and a cupboard (empty) here.

* * *

>e
Kitchen
You can see a back door, a stove (on which is a pot) and a fridge (empty) here.

>e
Bonk! The back door is closed.

* * *

>e
Back Yard
You are standing in the grass next to an inviting trampoline.

You can see a back door, a trampoline (closed) and a toy yellow dump truck here.

>x truck
You notice a jubilant egg in the bed of the toy yellow dump truck!

>get egg
(the jubilant egg)
Taken.

>i
You are carrying:
  a jubilant egg
  a joyful Easter egg
  a yellow Easter egg
  a mauve egg
  a teal egg
  a fuchsia egg
  a spotted egg
  a turquoise egg
  a perplexed egg
  a happy egg
  a pink egg
  a purple Easter egg
  an orange Easter egg
  a blue Easter egg
  a green Easter egg
  a red Easter egg (open but empty)

>l
Back Yard
You are standing in the grass next to an inviting trampoline.

You can see a back door, a trampoline (closed) and a toy yellow dump truck here.

>open trampoline
It isn't something you can open.

* * *

>read message
The message says "Find me in the real world."

>score
You have so far scored 0 out of a possible 0, in 5 turns.

* * *

>open egg
You open the red Easter egg, revealing a message.

>showme message
message - thing
location: in the red Easter egg carried by yourself in the Bedroom
unlit, inedible, portable; singular-named, improper-named
description: none
initial appearance: "Find me in the real world."
printed name: "message"
printed plural name: none
indefinite article: none
list grouping key: none

>read message
The message says "".

>x message
The message says "".

* * *

>open egg
You open the red Easter egg, revealing a message.

>undo
Bedroom
[Previous turn undone.]

>actions
Actions listing on.

>open egg
[opening the red Easter egg]
You open the red Easter egg, revealing nothing.
[opening the red Easter egg - succeeded]

>showme egg
(the red Easter egg)
red Easter egg - open container
    message
location: carried by yourself in the Bedroom
unlit, inedible, portable, handled; opaque, open, openable, unlocked; singular-named, improper-named
description: none
initial appearance: none
carrying capacity: 100
printed name: "red Easter egg"
printed plural name: "containers"
indefinite article: none
list grouping key: none

>showme nightstand
nightstand - open container
location: in the Bedroom
unlit, inedible, portable; opaque, open, openable, unlocked; singular-named, improper-named
description: none
initial appearance: none
carrying capacity: 100
printed name: "nightstand"
printed plural name: "containers"
indefinite article: none
list grouping key: none

I beg your pardon?

* * *

>get egg
Taken.

>open it
You open the red Easter egg, revealing a message.

>open egg
It isn't something you can open.

* * *

>open it
You open the red Easter egg, revealing a message.

>read it
In the red Easter egg is a message.

>read message
You see nothing special about the message.

* * *

>get egg
Taken.

>rules
Rules tracing now switched on. Type "rules off" to switch it off again, or "rules all" to include even rules which do not apply.

[Rule "parse command rule" applies.]

* * *

The Great Beacon Hill Egg Hunt
An Egg-stravagant Fiction by E. Bunny
Release 1 / Serial number 230412 / Inform 7 v10.1.2 / D

Bedroom
The master bedroom is tastefully furnished and has a vaulted ceiling. You can exit by going down, west, or east.

You can see a bed (on which is a pillow) and a blue backpack (closed) here.

>rooms
That's not a verb I recognise.

>showme 21stBayview
21stBayview - room
    flower bed - supporter
        pink egg
lighted, unvisited; singular-named, proper-named
description: "You are at a nice traffic circle. An inviting sidewalk beckons to the south."
printed name: "21stBayview"
printed plural name: none
indefinite article: none
list grouping key: none

>showme 21st & Forest
21st & Forest - room
lighted, unvisited; singular-named, proper-named
description: "You are at a traffic circle to the east of the library."
printed name: "21st & Forest"
printed plural name: none
indefinite article: none
list grouping key: none

>rooms
That's not a verb I recognise.

>showme rooms
(the Bedroom)
Bedroom - room
    yourself - person
    bed - supporter
        pillow
    nightstand - closed container
        *red Easter egg - closed container
            *message
* denotes things which are not in scope
lighted, visited; singular-named, improper-named
description: "The master bedroom is tastefully furnished and has a vaulted ceiling. You can exit by going down."
printed name: "Bedroom"
printed plural name: none
indefinite article: none
list grouping key: none

* * *

The Great Beacon Hill Egg Hunt
An Egg-stravagant Fiction by E. Bunny
Release 1 / Serial number 230412 / Inform 7 v10.1.2 / D

Bedroom
The master bedroom is tastefully furnished and has a vaulted ceiling. You can exit by going down, west, or east.

You can see a bed (on which is a pillow) and a blue backpack (closed) here.

>rules
Rules tracing now switched on. Type "rules off" to switch it off again, or "rules all" to include even rules which do not apply.

[Rule "parse command rule" applies.]

>actions
[Rule "declare everything initially unmentioned rule" applies.]
[Rule "generate action rule" applies.]
Actions listing on.

[Rule "parse command rule" applies.]

* * *

>rules
Rules tracing now switched on. Type "rules off" to switch it off again, or "rules all" to include even rules which do not apply.

[Rule "parse command rule" applies.]

>open nightstand
[Rule "declare everything initially unmentioned rule" applies.]
[Rule "generate action rule" applies.]
[Rule "announce items from multiple object lists rule" applies.]
[Rule "set pronouns from items from multiple object lists rule" applies.]
[Rule "before stage rule" applies.]
[Rule "basic visibility rule" applies.]
[Rule "basic accessibility rule" applies.]
[Rule "access through barriers rule" applies.]
[Rule "carrying requirements rule" applies.]
[Rule "instead stage rule" applies.]
[Rule "requested actions require persuasion rule" applies.]
[Rule "carry out requested actions rule" applies.]
[Rule "descend to specific action-processing rule" applies.]
[Rule "work out details of specific action rule" applies.]
[Rule "investigate player's awareness before action rule" applies.]
[Rule "player aware of his own actions rule" applies.]
[Rule "check stage rule" applies.]
[Rule "can't open unless openable rule" applies.]
[Rule "can't open what's locked rule" applies.]
[Rule "can't open what's already open rule" applies.]
[Rule "carry out stage rule" applies.]
[Rule "standard opening rule" applies.]
[Rule "after stage rule" applies.]
[Rule "investigate player's awareness after action rule" applies.]
[Rule "report stage rule" applies.]
[Rule "reveal any newly visible interior rule" applies.]
You open the nightstand, revealing a red Easter egg.
[Rule "last specific action-processing rule" applies.]

[Rule "A first turn sequence rule" applies.]
[Rule "scene change machinery rule" applies.]
[Rule "every turn stage rule" applies.]
[Rule "timed events rule" applies.]
[Rule "advance time rule" applies.]
[Rule "update chronological records rule" applies.]
[Rule "A last turn sequence rule" applies.]
[Rule "scene change machinery rule" applies.]
[Rule "adjust light rule" applies.]
[Rule "note object acquisitions rule" applies.]
[Rule "notify score changes rule" applies.]
[Rule "parse command rule" applies.]

>get egg
[Rule "declare everything initially unmentioned rule" applies.]
[Rule "generate action rule" applies.]
[Rule "announce items from multiple object lists rule" applies.]
[Rule "set pronouns from items from multiple object lists rule" applies.]
[Rule "before stage rule" applies.]
[Rule "basic visibility rule" applies.]
[Rule "basic accessibility rule" applies.]
[Rule "access through barriers rule" applies.]
[Rule "can't reach inside rooms rule" applies.]
[Rule "can't reach inside closed containers rule" applies.]
[Rule "carrying requirements rule" applies.]
[Rule "instead stage rule" applies.]
[Rule "requested actions require persuasion rule" applies.]
[Rule "carry out requested actions rule" applies.]
[Rule "descend to specific action-processing rule" applies.]
[Rule "work out details of specific action rule" applies.]
[Rule "investigate player's awareness before action rule" applies.]
[Rule "player aware of his own actions rule" applies.]
[Rule "check stage rule" applies.]
[Rule "can't take yourself rule" applies.]
[Rule "can't take other people rule" applies.]
[Rule "can't take component parts rule" applies.]
[Rule "can't take people's possessions rule" applies.]
[Rule "can't take items out of play rule" applies.]
[Rule "can't take what you're inside rule" applies.]
[Rule "can't take what's already taken rule" applies.]
[Rule "can't take scenery rule" applies.]
[Rule "can only take things rule" applies.]
[Rule "can't take what's fixed in place rule" applies.]
[Rule "use player's holdall to avoid exceeding carrying capacity rule" applies.]
[Rule "can't exceed carrying capacity rule" applies.]
[Rule "carry out stage rule" applies.]
[Rule "standard taking rule" applies.]
[Rule "after stage rule" applies.]
[Rule "investigate player's awareness after action rule" applies.]
[Rule "report stage rule" applies.]
[Rule "standard report taking rule" applies.]
Taken.
[Rule "last specific action-processing rule" applies.]

[Rule "A first turn sequence rule" applies.]
[Rule "scene change machinery rule" applies.]
[Rule "every turn stage rule" applies.]
[Rule "timed events rule" applies.]
[Rule "advance time rule" applies.]
[Rule "update chronological records rule" applies.]
[Rule "A last turn sequence rule" applies.]
[Rule "scene change machinery rule" applies.]
[Rule "adjust light rule" applies.]
[Rule "note object acquisitions rule" applies.]
[Rule "notify score changes rule" applies.]
[Rule "parse command rule" applies.]

>open egg
[Rule "declare everything initially unmentioned rule" applies.]
[Rule "generate action rule" applies.]
[Rule "announce items from multiple object lists rule" applies.]
[Rule "set pronouns from items from multiple object lists rule" applies.]
[Rule "before stage rule" applies.]
[Rule "basic visibility rule" applies.]
[Rule "basic accessibility rule" applies.]
[Rule "access through barriers rule" applies.]
[Rule "carrying requirements rule" applies.]
[Rule "instead stage rule" applies.]
[Rule "requested actions require persuasion rule" applies.]
[Rule "carry out requested actions rule" applies.]
[Rule "descend to specific action-processing rule" applies.]
[Rule "work out details of specific action rule" applies.]
[Rule "investigate player's awareness before action rule" applies.]
[Rule "player aware of his own actions rule" applies.]
[Rule "check stage rule" applies.]
[Rule "can't open unless openable rule" applies.]
[Rule "can't open what's locked rule" applies.]
[Rule "can't open what's already open rule" applies.]
[Rule "carry out stage rule" applies.]
[Rule "standard opening rule" applies.]
[Rule "after stage rule" applies.]
[Rule "investigate player's awareness after action rule" applies.]
[Rule "report stage rule" applies.]
[Rule "reveal any newly visible interior rule" applies.]
You open the red Easter egg, revealing nothing.
[Rule "last specific action-processing rule" applies.]

[Rule "A first turn sequence rule" applies.]
[Rule "scene change machinery rule" applies.]
[Rule "every turn stage rule" applies.]
[Rule "timed events rule" applies.]
[Rule "advance time rule" applies.]
[Rule "update chronological records rule" applies.]
[Rule "A last turn sequence rule" applies.]
[Rule "scene change machinery rule" applies.]
[Rule "adjust light rule" applies.]
[Rule "note object acquisitions rule" applies.]
[Rule "notify score changes rule" applies.]
[Rule "parse command rule" applies.]

* * *

>restart
Are you sure you want to restart?

>y
The Great Beacon Hill Egg Hunt
An Egg-stravagant Fiction by E. Bunny
Release 1 / Serial number 230321 / Inform 7 v10.1.2 / D

Bedroom
The master bedroom is tastefully furnished and has a vaulted ceiling. You can exit by going down.

You can see a bed (on which is a pillow) and a nightstand (closed) here.

>test houseeggs
(Testing.)

>[1] gonear bedroom
Bedroom
The master bedroom is tastefully furnished and has a vaulted ceiling. You can exit by going down.

You can see a bed (on which is a pillow) and a nightstand (closed) here.

>[2] open nightstand
You open the nightstand, revealing a red Easter egg.

>[3] get egg
[Your score has just gone up by ten points.]

>[4] open egg
You open the red Easter egg, revealing a message.

>[5] read message
The message says "Find us in the real world."

>[6] down

Living Room
There are big windows here and a comfy looking recliner.

You can see a garage door, a couch and a footrest (closed) here.

>[7] open footrest
You open the footrest, revealing a green Easter egg.

>[8] get egg
(the green Easter egg)
[Your score has just gone up by ten points.]

>[9] nw

Bathroom
You can see a sink (on which is a bar of soap) and a cabinet (closed) here.

>[10] open cabinet
You open the cabinet, revealing a yellow Easter egg.

>[11] get egg
(the yellow Easter egg)
[Your score has just gone up by ten points.]

>[12] se

Living Room
There are big windows here and a comfy looking recliner.

You can see a garage door, a couch and a footrest (empty) here.

>[13] north

Kitchen
You can see a back door, a stove (on which is a pot) and a fridge (closed) here.

>[14] open fridge
You open the fridge, revealing a blue Easter egg.

>[15] get egg
(the blue Easter egg)
[Your score has just gone up by ten points.]

>[16] w

Dining Room
You can see a table (on which is an utensil holder) and a cupboard (closed) here.

>[17] open cupboard
You open the cupboard, revealing an orange Easter egg.

>[18] get egg
(the orange Easter egg)
[Your score has just gone up by ten points.]

>[19] w

Front Room
You can see a front door, a rack (on which is a coat) and a bin (closed) here.

>[20] open bin
You open the bin, revealing a purple Easter egg.

>[21] get egg
(the purple Easter egg)
[Your score has just gone up by ten points.]

>restart
Are you sure you want to restart?

* * *

>y
The Great Beacon Hill Egg Hunt
An Egg-stravagant Fiction by E. Bunny
Release 1 / Serial number 230321 / Inform 7 v10.1.2 / D

Bedroom
The master bedroom is tastefully furnished and has a vaulted ceiling. You can exit by going down.

You can see a bed (on which is a pillow) and a nightstand (closed) here.

>test outsideeggs
(Testing.)

>[1] gonear front room
Front Room
You can see a front door, a rack (on which is a coat) and a bin (closed) here.

>[2] open door
You open the front door.

>[3] w

Front Porch
You are on a wooden front porch.

You can see a front door and Smith Brothers milk crate (closed) here.

>[4] open crate
You open Smith Brothers milk crate, revealing a joyful Easter egg.

>[5] get egg
[Your score has just gone up by ten points.]

>[6] w

Front Yard
A nice front yard with a yellow fire hydrant.

You can see a mailbox (closed) here.

>[7] sw

21st & Bayview
You are at a nice traffic circle. Inviting sidewalks lead southwest and northeast.

You can see a flower bed here.

>[8] x bed
You notice a pink egg between the plants!

>[9] get egg
(the pink egg)
[Your score has just gone up by ten points.]

>[10] s
You can't go that way.

>[11] x circle
You can't see any such thing.

>[12] get egg
Which do you mean, the pink egg or the joyful Easter egg?

>[13] se
You must name something more substantial.

>[14] x plants
You can't see any such thing.

>[15] get egg
Which do you mean, the pink egg or the joyful Easter egg?

>[16] s
I only understood you as far as wanting to get south.

>[17] x sign
You can't see any such thing.

>[18] get egg
Which do you mean, the pink egg or the joyful Easter egg?

>[19] w
I only understood you as far as wanting to get west.

>[20] x bench
You can't see any such thing.

>[21] get egg
Which do you mean, the pink egg or the joyful Easter egg?

>[22] w
I only understood you as far as wanting to get west.

>[23] x wall
You can't see any such thing.

>[24] get egg
Which do you mean, the pink egg or the joyful Easter egg?

>[25] sw
You must name something more substantial.

>[26] x boxes
You can't see any such thing.

>[27] get egg
Which do you mean, the pink egg or the joyful Easter egg?

>[28] n
I only understood you as far as wanting to get north.

>[29] x poem
You can't see any such thing.

>[30] get egg
Which do you mean, the pink egg or the joyful Easter egg?

* * *

>score
You have so far scored 150 out of a possible 160, in 71 turns.

>i
You are carrying:
  some paper
  a jubilant egg
  a mauve egg
  a teal egg
  a fuchsia egg
  a spotted egg
  a turquoise egg
  a perplexed egg
  a happy egg
  a pink egg
  a joyful Easter egg
  a purple Easter egg
  an orange Easter egg
  a blue Easter egg
  a yellow Easter egg
  a green Easter egg
  a red Easter egg (open)
    a message

* * *

The Great Beacon Hill Egg Hunt
An Egg-stravagant Fiction by E. Bunny
Release 1 / Serial number 230412 / Inform 7 v10.1.2 / D

Bedroom
The master bedroom is tastefully furnished and has a vaulted ceiling. You can exit by going down, west, or east.

You can see a bed (on which is a pillow) and a blue backpack (closed) here.

>test houseeggs
(Testing.)

>[1] gonear bedroom
Bedroom
The master bedroom is tastefully furnished and has a vaulted ceiling. You can exit by going down.

You can see a bed (on which is a pillow) and a nightstand (closed) here.

>[2] open nightstand
You open the nightstand, revealing a red Easter egg.

>[3] get egg
[Your score has just gone up by ten points.]

>[4] open egg
You open the red Easter egg, revealing a message.

>[5] read message
The message says "Find me in the real world."

>[6] down

Living Room
You can see a garage door, a couch and a footrest (closed) here.

>[7] open footrest
You open the footrest, revealing a green Easter egg.

>[8] get egg
(the green Easter egg)
[Your score has just gone up by ten points.]

>[9] nw

Bathroom
You can see a sink (on which is a bar of soap) and a cabinet (closed) here.

>[10] open cabinet
You open the cabinet, revealing a yellow Easter egg.

>[11] get egg
(the yellow Easter egg)
Taken.

>[12] se

Living Room
You can see a garage door, a couch and a footrest (empty) here.

>[13] north

Kitchen
You can see a back door, a stove (on which is a pot) and a fridge (closed) here.

>[14] open fridge
You open the fridge, revealing a blue Easter egg.

>[15] get egg
(the blue Easter egg)
[Your score has just gone up by ten points.]

>[16] w

Dining Room
You can see a table (on which is an utensil holder) and a cupboard (closed) here.

>[17] open cupboard
You open the cupboard, revealing an orange Easter egg.

>[18] get egg
(the orange Easter egg)
[Your score has just gone up by ten points.]

>[19] w

Front Room
You can see a front door, a rack (on which is a coat) and a bin (closed) here.

>[20] open bin
You open the bin, revealing a purple Easter egg.

>[21] get egg
(the purple Easter egg)
[Your score has just gone up by ten points.]

>open door
You open the front door.

* * *

>w
Front Yard
A nice front yard with a yellow fire hydrant.

You can see a mailbox (closed) here.

>e
Front Porch
You are on a wooden front porch.

You can see a front door and Smith Brothers milk crate (closed) here.

>open crate
You open Smith Brothers milk crate, revealing a joyful Easter egg.

>get egg
(the joyful Easter egg)
[Your score has just gone up by ten points.]

>w
Front Yard
A nice front yard with a yellow fire hydrant.

You can see a mailbox (closed) here.

* * *

>x bed
You notice a pink egg between the plants!

>get egg
(the pink egg)
[Your score has just gone up by ten points.]

>s
20th & Forest
You are at a traffic circle to the east of the library. A path also leads southeast.

You can see a traffic circle here.

>x circle
You notice a happy egg in the traffic circle!

>get egg
(the happy egg)
[Your score has just gone up by ten points.]

>se
22nd & Stevens
Great looking traffic circle on 22nd. The road bends down to the south.

You can see some scrubby plants here.

>x plants
You notice a perplexed egg in the scrubby plants!

>get egg
(the perplexed egg)
[Your score has just gone up by ten points.]

>s
The Bowl
A dip in the street from all directions, looks like an interesting place to ride a bike.

You can see Base of street sign here.

* * *

>x sign
You notice a turquoise egg at the bottom of the pole!

>get egg
(the turquoise egg)
[Your score has just gone up by ten points.]

>w
Arrow Bench
An attractive spot with a beautiful wooden bench in the shape of an arrow.

You can see under the bench here.

* * *

>x bench
You notice a spotted egg under the bench!

>get egg
(the spotted egg)
[Your score has just gone up by ten points.]

>w
National Park
You look out toward the Cascades.  What a view! There is a low wall here.

You can see behind the wall here.

* * *

>x wall
You notice a fuchsia egg behind the wall!

>get egg
(the fuchsia egg)
[Your score has just gone up by ten points.]

>w
You can't go that way.

>sw
Firehouse
A lovely old firehouse from 1930 with a story illustrated on rocks out front.

You can see three raised tree boxes here.

* * *

>x boxes
You notice a teal egg in the middle tree box!

>get egg
(the teal egg)
[Your score has just gone up by ten points.]

>n
Library
A beautiful library with a dream ship out front.

You can see a spring poem here.

* * *

>x poem
You notice a mauve egg lying beside the spring poem!

>get egg
(the mauve egg)
[Your score has just gone up by ten points.]

>e
20th & Forest
You are at a traffic circle to the east of the library. A path also leads southeast.

You can see a traffic circle here.

>i
You are carrying:
  a mauve egg
  a teal egg
  a fuchsia egg
  a spotted egg
  a turquoise egg
  a perplexed egg
  a happy egg
  a pink egg
  a joyful Easter egg
  a purple Easter egg
  an orange Easter egg
  a blue Easter egg
  a yellow Easter egg
  a green Easter egg
  a red Easter egg (open)
    a message

>n
21st & Bayview
You are at a nice traffic circle. An inviting sidewalk beckons to the south.

You can see a flower bed here.

>ne
Front Yard
A nice front yard with a yellow fire hydrant.

You can see a mailbox (closed) here.

>e
Front Porch
You are on a wooden front porch.

You can see a front door and Smith Brothers milk crate (empty) here.

>e
Front Room
You can see a front door, a rack (on which is a coat) and a bin (empty) here.

* * *

>e
Kitchen
You can see a back door, a stove (on which is a pot) and a fridge (empty) here.

>open door
You open the back door.

* * *

>e
Back Yard
You are standing in the grass next to an inviting trampoline.

You can see a back door, a trampoline (closed) and a toy yellow dump truck here.

>open trampoline
You open the trampoline.

>get on trampoline
That's not something you can enter.

>enter trampoline
That's not something you can enter.

>get in trampoline
That's not something you can enter.

>bounce
What do you want to bounce on?

>trampoline
You jump on the trampoline and bounce up and down. Whee!

Back Yard (in the trampoline)
You are standing in the grass next to an inviting trampoline.

You can see a back door and a toy yellow dump truck here.

>x truck
You notice a jubilant egg in the bed of the toy yellow dump truck!

>get it
That's fixed in place.

>get egg
(the jubilant egg)
[Your score has just gone up by ten points.]

>w
You would have to get out of the trampoline first.

>get out
You get out of the trampoline.

Back Yard
You are standing in the grass next to an inviting trampoline.

You can see a back door, a trampoline (empty) and a toy yellow dump truck here.

* * *

The Great Beacon Hill Egg Hunt
An Egg-stravagant Fiction by E. Bunny
Release 1 / Serial number 230412 / Inform 7 v10.1.2 / D

Bedroom
The master bedroom is tastefully furnished and has a vaulted ceiling. You can exit by going down, west, or east.

You can see a bed (on which is a pillow) and a blue backpack (closed) here.

>test me
(Testing.)

>[1] open nightstand
You open the nightstand, revealing a red Easter egg.

>[2] get egg
[Your score has just gone up by ten points.]

>[3] open egg
You open the red Easter egg, revealing a message.

>[4] read message
The message says "Find me in the real world."

>[5] down

Living Room
You can see a garage door, a couch and a footrest (closed) here.

>[6] open footrest
You open the footrest, revealing a green Easter egg.

>[7] get egg
(the green Easter egg)
[Your score has just gone up by ten points.]

>[8] nw

Bathroom
You can see a sink (on which is a bar of soap) and a cabinet (closed) here.

>[9] open cabinet
You open the cabinet, revealing a yellow Easter egg.

>[10] get egg
(the yellow Easter egg)
Taken.

>[11] se

Living Room
You can see a garage door, a couch and a footrest (empty) here.

>[12] north

Kitchen
You can see a back door, a stove (on which is a pot) and a fridge (closed) here.

>[13] open fridge
You open the fridge, revealing a blue Easter egg.

>[14] get egg
(the blue Easter egg)
[Your score has just gone up by ten points.]

>[15] w

Dining Room
You can see a table (on which is an utensil holder) and a cupboard (closed) here.

>[16] open cupboard
You open the cupboard, revealing an orange Easter egg.

>[17] get egg
(the orange Easter egg)
[Your score has just gone up by ten points.]

>[18] w

Front Room
You can see a front door, a rack (on which is a coat) and a bin (closed) here.

>[19] open bin
You open the bin, revealing a purple Easter egg.

>[20] get egg
(the purple Easter egg)
[Your score has just gone up by ten points.]

>d
Living Room
You can see a garage door, a couch and a footrest (closed) here.

* * *

>open footrest
You open the footrest, revealing a green Easter egg.

>get egg
(the green Easter egg)
[Your score has just gone up by ten points.]

>n
Kitchen
You can see a back door, a stove (on which is a pot) and a fridge (closed) here.

* * *

>open fridge
You open the fridge, revealing a blue Easter egg.

>get egg
(the blue Easter egg)
[Your score has just gone up by ten points.]

>w
Dining Room
You can see a table (on which is an utensil holder) and a cupboard (closed) here.

>e
Kitchen
You can see a back door, a stove (on which is a pot) and a fridge (empty) here.

* * *

>score
You have so far scored 50 out of a possible 160, in 21 turns.

>gonear front yard
Front Yard
A nice front yard with a yellow fire hydrant.

You can see a mailbox (closed) here.

>gonear bedroom
Bedroom
The master bedroom is tastefully furnished and has a vaulted ceiling. You can exit by going down.

You can see a bed (on which is a pillow) and a nightstand (empty) here.

* * *

>w
Dining Room
You can see a table (on which is an utensil holder) and a cupboard (closed) here.

* * *

>open cupboard
You open the cupboard, revealing an orange Easter egg.

>get egg
(the orange Easter egg)
[Your score has just gone up by ten points.]

>w
Front Room
You can see a front door, a rack (on which is a coat) and a bin (closed) here.

* * *

>open bin
You open the bin, revealing a purple Easter egg.

>get egg
(the purple Easter egg)
[Your score has just gone up by ten points.]

* * *

The Great Beacon Hill Egg Hunt
An Egg-stravagant Fiction by E. Bunny
Release 1 / Serial number 230412 / Inform 7 v10.1.2 / D

Bedroom
The master bedroom is tastefully furnished and has a vaulted ceiling. You can exit by going down, west, or east.

You can see a bed (on which is a pillow) and a blue backpack (closed) here.

>test outsideeggs
(Testing.)

>[1] gonear front room
Front Room
You can see a front door, a rack (on which is a coat) and a bin (closed) here.

>[2] open door
You open the front door.

>[3] w

*** Run-time problem P49: Memory allocation proved impossible.

* * *

The Great Beacon Hill Egg Hunt
An Egg-stravagant Fiction by E. Bunny
Release 1 / Serial number 230412 / Inform 7 v10.1.2 / D

Bedroom
The master bedroom is tastefully furnished and has a vaulted ceiling. You can exit by going down, west, or east.

You can see a bed (on which is a pillow) and a blue backpack (closed) here.

>test safe
(Testing.)

>[1] gonear bedroom
Bedroom
The master bedroom is tastefully furnished and has a vaulted ceiling. You can exit by going down.

You can see a bed (on which is a pillow) and a nightstand (closed) here.

>[2] d

Living Room
You can see a garage door, a couch and a footrest (closed) here.

>[3] open door
You open the garage door.

>[4] w

Garage
You can see a garage door and a safe (closed) here.

>[5] x safe
You haven't dialed the safe to any combination yet.

>[6] set safe to 2
You dial 2 on the safe.

>[7] set safe to 10
You dial 10 on the safe.

>[8] set safe to 11
You dial 11, and the safe gives a joyous CLICK.

>[9] open safe
You open the safe, revealing some paper.

>set safe to 2
You dial 2 on the safe.

>get paper
Taken.

>read paper
You read the message on the paper:  .-… - - -.- / … -. / - .-. … … - .- -. … / -.-. .-… - … . -

* * *

The Great Beacon Hill Egg Hunt
An Egg-stravagant Fiction by E. Bunny
Release 1 / Serial number 230412 / Inform 7 v10.1.2 / D

Bedroom
The master bedroom is tastefully furnished and has a vaulted ceiling. You can exit by going down, west, or east.

You can see a bed (on which is a pillow) and a blue backpack (closed) here.

>w
What, you want to break the window!? Nice try.

>e
Hallway
A hallway that you thought you'd seen many times before, but something seems to be different about it this time. You might be able to go (a mystery direction-- hahahaha I'm not telling) through the portal.

You can see a portal, a washing machine (on which is a dryer) and a hamper (closed) here.

>d
Living Room
There are big windows here and a comfy looking recliner. You can go up, northwest, north, or west into the garage.

You can see a garage door, a couch and a footrest (closed) here.

* * *

>w
Bonk! The garage door is closed.

>n
Kitchen
Granite countertops adorn this small kitchen. You can see the back yard outside a door to the east and a dining room to the west. 

You can see a back door, a stove (on which is a pot) and a fridge (closed) here.

* * *

>w
Front Room
The front entry room of the house. An attractive blue rug adds to the warmth. Out the window is a beautiful city skyline.

You can see a front door, a rack (on which is a coat), a black bin (closed) and a hamper (closed) here.

>open hamper
You open the hamper, revealing a stack of dirty clothes.

>get clothes
[Your score has just gone down by ten points.]

* * *

>e
Hallway
A hallway that you thought you'd seen many times before, but something seems to be different about it this time. You might be able to go (a mystery direction-- hahahaha I'm not telling) through the portal.

You can see a portal, a washing machine (on which is a dryer) and a hamper (closed) here.

>open portal
You open the portal.

>go through portal
Ohio
The portal needed somewhere to go but I don't feel like making another room right now

You can see a portal here.

>s
Hallway
A hallway that you thought you'd seen many times before, but something seems to be different about it this time. You might be able to go (a mystery direction-- hahahaha I'm not telling) through the portal.

You can see a portal, a washing machine (on which is a dryer) and a hamper (closed) here.

>l
Hallway
A hallway that you thought you'd seen many times before, but something seems to be different about it this time. You might be able to go (a mystery direction-- hahahaha I'm not telling) through the portal.

You can see a portal, a washing machine (on which is a dryer) and a hamper (closed) here.

>w
What, you want to break the window!? Nice try.

>break the window
You can't see any such thing.

* * *

>w
What, you want to break the window!? Nice try.

>n
Bonk! The portal is closed.

>open portal
You open the portal.

>n
Ohio
The portal needed somewhere to go but I don't feel like making another room right now

You can see a portal here.

* * *

>w
What, you want to break the window!? Nice try.

>open hamper
You open the hamper, revealing a stack of dirty clothes.

>get in machine
That's not something you can enter.

>take dryer
Taken.

>l
Hallway
A hallway that you thought you'd seen many times before, but something seems to be different about it this time.

You can see a washing machine and a hamper (in which is a stack of dirty clothes) here.

>get hamper
Taken.

>get clothes
Why do you need those dirty clothes!? You can't wash them (yet!) Quit carrying them around!

[Your score has just gone down by ten points.]

>put clothes in hamper
You put the stack of dirty clothes into the hamper.

>drop clothes
You haven't got that.

>get clothes
Why do you need those dirty clothes!? You can't wash them (yet!) Quit carrying them around!

[Your score has just gone down by ten points.]

>drop clothes
Oh, good to see you still have some common sense.

[Your score has just gone up by ten points.]

>drop clothes
The stack of dirty clothes is already here.

>e
Bedroom
The master bedroom is tastefully furnished and has a vaulted ceiling. You can exit by going down or west.

You can see a bed (on which is a pillow) and a blue backpack (closed) here.